0 0 0 1 0 0 0 0 0 0 0 0 0 0 0 1 0 0 0 0 0 0 0 0 0 0 0 0 1 1 0 0 0 0 0 0 0 0 0 0 0 0 0 0 0 1 0 0 0 0 
0 0 0 0 1 0 0 0 0 0 1 1 0 0 0 0 0 0 1 0 0 0 1 1 1 0 0 0 0 0 0 0 0 0 0 0 1 1 1 0 1 0 1 0 0 0 0 0 1 0 
0 1 0 0 0 0 0 10 6 6 6 13 0 0 0 1 1 0 0 0 0 1 0 0 0 1 0 0 0 0 0 0 0 1 0 0 0 0 0 0 0 0 0 0 0 1 1 0 0 0 
0 0 1 1 0 0 0 5 14 14 14 4 6 6 6 6 6 13 0 1 0 1 1 1 1 1 1 0 0 10 6 6 6 6 6 6 6 6 6 13 0 0 1 0 0 0 1 0 0 0 
0 0 0 0 10 6 5 14 14 14 14 14 14 14 14 14 14 4 6 13 0 0 0 1 1 1 10 6 6 5 14 14 14 14 14 14 14 14 14 4 13 0 0 1 0 0 1 0 0 0 
0 0 0 0 7 14 14 14 14 14 14 14 14 14 14 14 14 14 14 4 6 6 6 6 6 6 5 14 14 14 14 14 14 14 14 14 14 14 14 14 4 13 0 1 0 0 0 0 0 0 
0 0 1 0 7 14 14 14 14 14 14 14 14 14 14 14 14 14 14 14 14 14 14 14 14 14 14 14 14 14 14 14 14 14 14 14 14 14 14 14 14 4 13 0 0 0 0 0 0 0 
0 0 1 0 11 3 14 14 14 14 14 14 14 14 14 14 14 14 14 14 14 14 14 14 14 14 14 14 14 14 14 14 14 14 14 14 14 14 14 14 14 14 4 13 0 1 1 0 1 0 
0 0 0 0 0 11 3 14 14 14 14 14 14 14 14 14 14 14 14 14 14 14 14 14 14 14 14 14 14 14 14 14 14 14 14 14 14 14 14 14 14 14 14 9 0 0 0 0 0 0 
0 0 1 0 0 0 7 14 14 14 14 14 14 14 14 14 14 14 14 14 14 14 14 14 14 14 14 14 14 14 14 14 14 14 14 14 14 14 14 14 14 14 14 9 1 1 0 1 0 0 
1 0 1 1 0 0 11 3 14 14 14 14 14 14 14 14 14 14 14 14 14 14 14 14 14 14 14 14 14 14 14 14 14 14 14 14 14 14 14 14 14 14 14 9 0 0 0 0 1 0 
1 0 0 0 0 0 0 11 3 14 14 14 14 14 14 14 14 14 14 14 14 14 14 14 14 14 14 14 14 14 14 14 14 14 14 14 14 14 14 14 14 14 14 4 6 6 13 0 0 0 
0 0 0 1 0 0 0 0 7 14 14 14 14 14 14 14 14 14 14 14 14 14 14 14 14 14 14 14 14 14 14 14 14 14 14 14 14 14 14 14 14 14 14 14 14 14 4 13 0 0 
0 0 0 1 1 0 10 6 5 14 14 14 14 14 14 14 14 14 14 14 14 14 14 14 14 14 14 14 14 14 14 14 14 14 14 14 14 14 14 14 14 14 14 14 14 14 14 4 13 1 
0 0 1 1 0 0 7 14 14 14 14 14 14 14 14 14 14 14 14 14 14 14 14 14 14 14 14 14 14 14 14 14 14 14 14 14 14 14 14 14 14 14 14 14 14 14 14 14 9 1 
0 1 1 0 10 6 5 14 14 14 14 14 14 14 14 14 14 14 14 14 14 14 14 14 14 14 14 14 14 14 14 14 14 14 14 14 14 14 14 14 14 14 14 14 14 14 14 14 9 0 
0 0 0 0 7 14 14 14 14 14 14 14 14 14 14 14 14 14 14 14 14 14 2 8 8 8 8 8 8 8 3 14 14 14 14 14 14 14 14 14 14 14 14 14 14 14 14 14 9 1 
0 0 0 0 7 14 14 14 14 14 14 14 14 14 14 14 14 14 14 14 14 2 12 0 1 0 1 0 1 0 7 14 14 14 14 14 14 14 14 14 14 14 14 14 14 14 14 2 12 0 
0 1 0 0 7 14 14 14 14 14 14 14 14 14 14 14 14 14 14 14 14 4 13 1 0 0 0 1 0 0 11 3 14 14 14 14 14 14 14 14 14 14 14 14 14 14 14 9 0 0 
0 0 0 0 7 14 14 14 14 14 14 14 14 14 14 14 14 14 14 14 14 14 4 6 6 6 6 6 13 1 0 7 14 14 14 14 14 14 14 14 14 14 14 14 14 14 2 12 1 1 
1 0 0 1 7 14 14 14 14 14 14 14 14 14 14 14 14 14 14 14 14 14 14 14 14 14 14 14 4 6 13 7 14 14 14 14 14 14 14 14 14 14 14 14 14 2 12 0 0 0 
0 0 0 0 7 14 14 14 14 14 14 14 14 14 14 14 14 14 14 14 14 14 14 14 14 14 14 14 14 14 4 5 14 14 14 14 14 14 14 14 14 14 14 14 14 9 0 0 0 0 
0 0 0 0 11 8 3 14 14 14 14 14 14 14 14 14 14 14 14 14 14 14 14 14 14 14 14 14 14 14 14 14 14 14 14 14 14 14 14 14 14 14 14 14 14 9 0 1 1 0 
0 1 0 0 1 0 7 14 14 14 14 14 14 14 14 14 14 14 14 14 14 14 14 14 14 14 14 14 14 14 14 14 14 14 14 14 14 14 14 14 14 14 14 14 14 9 0 0 1 0 
0 0 0 0 0 0 7 14 14 14 14 14 14 14 14 14 14 14 14 14 14 14 14 14 14 14 14 14 14 14 14 14 14 14 14 14 14 14 14 14 14 14 14 14 14 9 0 0 0 0 
0 0 1 1 0 0 7 14 14 14 14 14 14 14 14 14 14 14 14 14 14 14 14 14 14 14 14 14 14 14 14 14 14 14 14 14 14 14 14 14 14 14 14 14 14 9 0 0 1 0 
0 0 1 1 0 0 7 14 14 14 14 14 14 14 14 14 14 14 14 14 14 14 14 14 14 14 14 14 14 14 14 14 14 14 14 14 14 14 14 14 14 14 14 14 14 9 0 0 1 0 
1 1 1 0 1 0 11 3 14 14 14 14 14 14 14 14 14 14 14 14 14 14 14 14 14 14 14 14 14 14 14 14 14 14 14 14 14 14 14 14 14 14 14 14 14 9 0 1 1 0 
1 0 0 0 0 1 0 7 14 14 14 14 14 14 14 14 14 14 14 14 14 14 14 14 14 14 14 14 14 14 14 14 14 14 14 14 14 14 14 14 14 14 14 14 14 9 0 1 0 0 
0 1 0 0 0 1 1 7 14 14 14 14 14 14 14 14 14 14 14 14 14 14 14 14 14 14 14 14 14 14 14 14 14 14 14 14 14 14 14 14 14 14 14 14 2 12 0 0 1 0 
0 1 1 1 0 0 10 5 14 14 14 14 14 14 14 14 14 14 14 14 14 14 14 14 14 14 14 14 14 14 14 14 14 14 14 14 14 14 14 14 14 14 14 2 12 0 1 0 1 0 
0 1 0 0 0 10 5 14 14 14 14 14 14 14 14 14 14 14 14 14 14 14 14 14 14 14 14 14 14 14 14 14 14 14 14 14 14 14 14 14 14 14 14 9 0 0 0 1 0 0 
0 0 0 0 10 5 14 14 14 14 14 14 14 14 14 14 14 14 14 14 14 14 14 14 14 14 14 14 14 14 14 14 14 14 14 14 14 14 14 14 14 14 14 9 0 0 0 0 0 0 
0 0 0 0 7 14 14 14 14 14 14 14 14 14 14 14 14 14 14 14 14 14 14 14 14 14 14 14 14 14 14 14 14 14 14 14 14 14 14 14 14 14 14 9 0 1 1 1 0 0 
0 0 1 0 7 14 14 14 14 14 14 14 14 14 14 14 14 14 14 14 14 14 14 14 14 14 14 14 14 14 14 14 14 14 14 14 14 14 14 14 14 14 14 9 0 0 0 1 0 0 
0 0 1 0 7 14 14 14 14 14 14 14 14 14 14 14 14 14 14 14 14 14 14 14 14 14 14 14 14 14 14 14 14 14 14 14 14 14 14 14 14 14 14 9 0 1 0 0 0 0 
1 1 0 0 7 14 14 14 14 14 14 14 14 14 14 14 14 14 14 14 14 14 14 14 14 14 14 14 14 14 14 14 14 14 14 14 14 14 14 14 14 14 14 9 0 0 1 0 0 0 
0 0 0 0 7 14 14 14 14 14 14 14 14 14 14 14 14 14 14 14 14 14 14 14 14 14 14 14 14 14 14 14 14 14 14 14 14 14 14 14 14 14 14 9 0 0 1 0 0 0 
0 0 1 1 7 14 14 14 14 14 14 14 14 14 14 14 14 14 14 14 14 14 14 14 14 14 14 14 14 14 14 14 14 14 14 14 14 14 2 8 8 8 8 12 0 0 0 0 0 0 
0 0 0 0 7 14 14 14 14 14 14 14 14 14 14 14 14 14 14 14 14 14 14 14 14 14 14 14 14 14 14 14 14 14 14 14 14 14 9 0 0 0 0 0 0 0 0 0 0 0 
0 1 0 0 7 14 14 14 14 14 14 14 14 14 14 14 14 14 14 14 14 14 14 14 14 14 14 14 14 14 14 14 14 14 14 14 2 8 12 0 0 1 0 0 1 1 1 1 0 0 
0 1 1 0 11 8 8 8 8 8 3 14 14 14 14 14 14 14 14 14 14 14 14 14 14 14 14 14 14 14 14 14 14 14 14 14 9 0 0 1 1 1 0 0 0 0 0 1 0 0 
0 1 0 0 0 0 0 0 0 0 7 14 14 14 14 14 14 14 14 14 14 14 14 14 14 14 14 14 14 14 14 14 14 14 14 14 9 1 0 0 0 0 0 0 0 0 1 0 0 0 
0 1 1 0 0 0 1 1 0 0 11 8 8 8 8 8 8 8 8 3 14 14 14 14 14 14 14 14 14 14 14 14 14 14 14 14 9 0 1 0 0 1 1 1 0 0 0 0 0 0 
0 0 0 1 0 0 0 0 0 1 0 0 0 0 0 0 0 0 0 7 14 14 14 14 14 14 14 14 14 14 14 14 14 14 14 14 9 0 0 0 0 0 0 0 0 0 0 1 1 0 
0 0 0 0 0 0 1 1 1 0 0 0 0 0 1 0 1 1 1 11 8 8 8 8 8 8 8 8 8 8 8 8 8 8 8 8 12 0 0 0 0 0 0 0 0 0 0 0 0 0 
0 0 0 0 0 0 0 0 0 0 0 0 0 0 0 0 0 0 1 0 0 0 0 0 0 0 1 1 0 0 0 0 1 0 0 0 0 0 1 1 0 0 1 1 1 0 0 0 0 1 
0 1 0 1 1 0 0 0 0 1 1 0 0 0 0 0 0 0 0 0 1 0 0 0 0 1 0 0 0 0 0 0 0 0 0 1 0 0 0 0 0 0 0 0 0 0 0 0 0 1 
0 1 1 1 0 0 0 0 0 0 0 0 0 0 1 1 1 0 0 0 1 0 0 0 1 1 0 0 0 0 1 1 0 0 0 1 1 0 0 0 0 1 1 1 1 0 0 1 0 0 
0 0 0 0 0 0 0 0 1 1 1 1 1 0 0 0 0 0 0 0 0 0 1 1 1 0 0 1 0 0 0 0 0 0 0 0 0 0 0 0 0 0 0 0 0 0 0 0 0 0 
