0 0 0 1 0 0 0 0 0 0 0 0 0 0 0 1 0 0 0 0 0 0 0 0 0 0 0 0 1 1 0 0 0 0 0 0 0 0 0 0 0 0 0 0 0 1 0 0 0 0 
0 0 0 0 1 0 0 0 0 0 1 1 0 0 0 0 0 0 1 0 0 0 1 1 1 0 0 0 0 0 0 0 0 0 0 0 1 1 1 0 1 0 1 0 0 0 0 0 1 0 
0 1 0 0 0 0 0 10 6 6 6 13 0 0 0 1 1 0 0 0 0 1 0 0 0 1 0 0 0 0 0 0 0 1 0 0 0 0 0 0 0 0 0 0 0 1 1 0 0 0 
0 0 1 1 0 0 0 5 15 15 15 4 6 6 6 6 6 13 0 1 0 1 1 1 1 1 1 0 0 10 6 6 6 6 6 6 6 6 6 13 0 0 1 0 0 0 1 0 0 0 
0 0 0 0 10 6 5 15 15 15 15 15 15 15 15 15 15 4 6 13 0 0 0 1 1 1 10 6 6 5 15 15 15 15 15 15 15 15 15 4 13 0 0 1 0 0 1 0 0 0 
0 0 0 0 7 15 15 15 15 15 15 15 15 15 15 15 15 15 15 4 6 6 6 6 6 6 5 15 15 15 15 15 15 15 15 15 15 15 15 15 4 13 0 1 0 0 0 0 0 0 
0 0 1 0 7 15 15 15 15 15 15 15 15 15 15 15 15 15 15 15 15 15 15 15 15 15 15 15 15 15 15 15 15 15 15 15 15 15 15 15 15 4 13 0 0 0 0 0 0 0 
0 0 1 0 11 3 15 15 15 15 15 15 15 15 15 15 15 15 15 15 15 15 15 15 15 15 15 15 15 15 15 15 15 15 15 15 15 15 15 15 15 15 4 13 0 1 1 0 1 0 
0 0 0 0 0 11 3 15 15 15 15 15 15 15 15 15 15 15 15 15 15 15 15 15 15 15 15 15 15 15 15 15 15 15 15 15 15 15 15 15 15 15 15 9 0 0 0 0 0 0 
0 0 1 0 0 0 7 15 15 15 15 15 15 15 15 15 15 15 15 15 15 15 15 15 15 15 15 15 15 15 15 15 15 15 15 15 15 15 15 15 15 15 15 9 1 1 0 1 0 0 
1 0 1 1 0 0 11 3 15 15 15 15 15 15 15 15 15 15 15 15 15 15 15 14 14 14 14 15 15 15 15 15 15 15 15 15 15 15 15 15 15 15 15 9 0 0 0 0 1 0 
1 0 0 0 0 0 0 11 3 15 15 15 15 15 15 15 15 15 15 15 15 14 14 14 14 14 14 15 15 15 15 15 15 15 15 15 14 14 15 15 15 15 15 4 6 6 13 0 0 0 
0 0 0 1 0 0 0 0 7 15 15 15 15 15 15 15 15 15 15 15 14 14 14 14 14 14 14 15 15 15 15 15 15 15 15 14 14 14 14 14 15 15 15 15 15 15 4 13 0 0 
0 0 0 1 1 0 10 6 5 15 15 15 15 15 15 15 15 15 15 15 15 14 14 14 15 15 15 15 15 15 15 15 15 15 15 14 14 14 14 14 15 15 15 15 15 15 15 4 13 1 
0 0 1 1 0 0 7 15 15 15 15 15 15 15 15 15 15 15 15 15 15 15 15 15 15 15 15 15 15 15 15 15 15 15 15 14 14 14 14 14 15 15 15 15 15 15 15 15 9 1 
0 1 1 0 10 6 5 15 15 15 15 15 15 15 15 15 15 15 15 15 15 15 15 15 15 15 15 15 15 15 15 15 15 15 15 15 14 14 14 15 15 15 15 15 15 15 15 15 9 0 
0 0 0 0 7 15 15 15 15 15 15 15 15 15 15 15 15 15 15 15 15 15 2 8 8 8 8 8 8 8 3 15 15 15 15 15 15 15 15 15 15 15 15 15 15 15 15 15 9 1 
0 0 0 0 7 15 15 15 15 15 15 15 15 15 15 15 15 15 15 15 15 2 12 0 1 0 1 0 1 0 7 15 15 15 15 15 15 15 15 15 15 15 15 15 15 15 15 2 12 0 
0 1 0 0 7 15 15 15 15 15 15 15 15 15 15 15 15 15 15 15 15 4 13 1 0 0 0 1 0 0 11 3 15 15 15 15 15 15 15 15 15 15 15 15 15 15 15 9 0 0 
0 0 0 0 7 15 15 15 15 15 15 15 15 15 15 15 15 15 15 15 15 15 4 6 6 6 6 6 13 1 0 7 15 15 15 15 15 15 15 15 15 15 15 15 15 15 2 12 1 1 
1 0 0 1 7 15 15 15 15 15 15 15 15 15 15 15 15 15 15 15 15 15 15 15 15 15 15 15 4 6 13 7 15 15 15 15 15 15 15 15 15 15 15 15 15 2 12 0 0 0 
0 0 0 0 7 15 15 15 15 15 15 15 15 15 15 15 15 15 15 15 15 15 15 15 15 15 15 15 15 15 4 5 15 15 15 15 15 15 15 15 15 15 15 15 15 9 0 0 0 0 
0 0 0 0 11 8 3 15 15 15 15 15 15 15 15 15 15 15 15 15 15 15 15 15 15 15 15 15 15 15 15 15 15 15 15 15 15 15 15 15 15 15 15 15 15 9 0 1 1 0 
0 1 0 0 1 0 7 15 15 15 15 15 15 15 15 15 15 15 15 15 15 15 15 15 15 15 15 15 15 15 15 15 15 15 15 15 15 14 15 15 15 15 15 15 15 9 0 0 1 0 
0 0 0 0 0 0 7 15 15 15 15 15 15 15 15 15 15 15 15 15 15 15 15 15 15 15 15 15 15 15 15 15 15 15 15 14 14 14 15 15 15 15 15 15 15 9 0 0 0 0 
0 0 1 1 0 0 7 15 15 15 15 15 15 15 15 15 15 15 15 15 15 15 15 15 15 15 15 15 15 15 15 15 15 15 15 14 14 14 15 15 15 15 15 15 15 9 0 0 1 0 
0 0 1 1 0 0 7 15 15 15 15 15 15 15 15 15 15 15 15 15 15 15 15 15 15 15 15 15 15 15 15 15 15 15 14 14 14 14 15 15 15 15 15 15 15 9 0 0 1 0 
1 1 1 0 1 0 11 3 15 15 15 15 15 15 15 15 15 15 15 15 15 15 15 15 15 15 15 15 15 15 15 15 15 15 14 14 14 14 15 15 15 15 15 15 15 9 0 1 1 0 
1 0 0 0 0 1 0 7 15 15 15 15 15 15 15 15 15 15 15 15 15 15 15 15 15 15 15 15 15 15 15 15 15 14 14 14 14 14 15 15 15 15 15 15 15 9 0 1 0 0 
0 1 0 0 0 1 1 7 15 15 15 15 15 15 15 15 15 15 15 15 15 15 15 15 15 15 15 15 15 15 15 15 15 14 14 14 14 14 15 15 15 15 15 15 2 12 0 0 1 0 
0 1 1 1 0 0 0 7 15 15 15 15 15 15 15 15 15 15 15 15 15 15 15 15 15 15 15 15 15 15 15 15 15 15 14 14 14 14 15 15 15 15 15 2 12 0 1 0 1 0 
0 1 0 0 10 6 6 5 15 15 15 15 15 15 15 15 15 15 15 15 15 15 15 15 15 15 15 15 15 15 15 15 15 15 15 14 14 15 15 15 15 15 15 9 0 0 0 1 0 0 
0 0 0 0 7 15 15 15 15 15 15 15 15 15 15 15 15 15 15 15 15 15 15 15 15 15 15 15 15 15 15 15 15 15 15 15 15 15 15 15 15 15 15 9 0 0 0 0 0 0 
0 0 0 0 7 15 15 15 15 15 15 15 15 15 15 15 15 15 15 15 15 15 15 15 15 15 15 15 15 15 15 15 15 15 15 15 15 15 15 15 15 15 15 9 0 1 1 1 0 0 
0 0 1 0 7 15 15 15 15 15 15 15 14 14 14 15 15 15 15 15 15 15 15 15 15 15 15 15 15 15 15 15 15 15 15 15 15 15 15 15 15 15 15 9 0 0 0 1 0 0 
0 0 1 0 7 15 15 15 15 15 14 14 14 14 14 15 15 15 15 15 15 15 15 14 14 14 15 15 15 15 15 15 15 15 15 15 15 15 15 15 15 15 15 9 0 1 0 0 0 0 
1 1 0 0 7 15 15 15 15 14 14 14 14 14 15 15 15 15 15 15 15 14 14 14 14 14 14 14 15 15 15 15 15 15 15 15 15 15 15 15 15 15 15 9 0 0 1 0 0 0 
0 0 0 0 7 15 15 15 15 14 14 14 14 14 15 15 15 15 15 15 15 14 14 14 14 14 14 14 15 15 15 15 15 15 15 15 15 15 15 15 15 15 15 9 0 0 1 0 0 0 
0 0 1 1 7 15 15 15 15 14 14 14 14 15 15 15 15 15 15 15 15 14 14 14 14 14 15 15 15 15 15 15 15 15 15 15 15 15 2 8 8 8 8 12 0 0 0 0 0 0 
0 0 0 0 7 15 15 15 15 15 15 15 15 15 15 15 15 15 15 15 15 15 15 15 15 15 15 15 15 15 15 15 15 15 15 15 15 15 9 0 0 0 0 0 0 0 0 0 0 0 
0 1 0 0 7 15 15 15 15 15 15 15 15 15 15 15 15 15 15 15 15 15 15 15 15 15 15 15 15 15 15 15 15 15 15 15 2 8 12 0 0 1 0 0 1 1 1 1 0 0 
0 1 1 0 11 8 8 8 8 8 3 15 15 15 15 15 15 15 15 15 15 15 15 15 15 15 15 15 15 15 15 15 15 15 15 15 9 0 0 1 1 1 0 0 0 0 0 1 0 0 
0 1 0 0 0 0 0 0 0 0 7 15 15 15 15 15 15 15 15 15 15 15 15 15 15 15 15 15 15 15 15 15 15 15 15 15 9 1 0 0 0 0 0 0 0 0 1 0 0 0 
0 1 1 0 0 0 1 1 0 0 11 8 8 8 8 8 8 8 8 3 15 15 15 15 15 15 15 15 15 15 15 15 15 15 15 15 9 0 1 0 0 1 1 1 0 0 0 0 0 0 
0 0 0 1 0 0 0 0 0 1 0 0 0 0 0 0 0 0 0 7 15 15 15 15 15 15 15 15 15 15 15 15 15 15 15 15 9 0 0 0 0 0 0 0 0 0 0 1 1 0 
0 0 0 0 0 0 1 1 1 0 0 0 0 0 1 0 1 1 1 11 8 8 8 8 8 8 8 8 8 8 8 8 8 8 8 8 12 0 0 0 0 0 0 0 0 0 0 0 0 0 
0 0 0 0 0 0 0 0 0 0 0 0 0 0 0 0 0 0 1 0 0 0 0 0 0 0 1 1 0 0 0 0 1 0 0 0 0 0 1 1 0 0 1 1 1 0 0 0 0 1 
0 1 0 1 1 0 0 0 0 1 1 0 0 0 0 0 0 0 0 0 1 0 0 0 0 1 0 0 0 0 0 0 0 0 0 1 0 0 0 0 0 0 0 0 0 0 0 0 0 1 
0 1 1 1 0 0 0 0 0 0 0 0 0 0 1 1 1 0 0 0 1 0 0 0 1 1 0 0 0 0 1 1 0 0 0 1 1 0 0 0 0 1 1 1 1 0 0 1 0 0 
0 0 0 0 0 0 0 0 1 1 1 1 1 0 0 0 0 0 0 0 0 0 1 1 1 0 0 1 0 0 0 0 0 0 0 0 0 0 0 0 0 0 0 0 0 0 0 0 0 0 
